***###****#*##*****#
#**#####*##*##*#*#*#
#**#***#*#*###*#*#*#
##**##***####*####*#
#***##**##**#*#*##*#
##******######**####
##*#*#####**#*#**#*#
#*****##*####***###*
#**#**###**#*#**#**#
*#*#****************